type octile
height 64
width 64
map
............TTTT........TTTT....TTTT...TTTTTTTTT................
............TTTT.........TTT.....T......TTTTTTTT....T...........
............TTTT........TTTT....TTTTT.T.TTTTTTTTT...T...........
.............T..........TTTT....TTTT.TT.T....TTTT...............
....................T..TTTTT....TTTTTTTTT....TTTT...............
.....................TTTTTT.....TTTTTTTTT.T.TTTTT...............
....................TTTTTTTT....TTTTTTTT..TTTTTT................
......................TTT.TT....T..TTTTT...T.TTT................
........T..T........................TTTTTTTTTTTT....T..T........
........T.T.........................TTTTTTTTTTTTT...TTTT........
........T.T.........................TTTTTTTTTTTTTTTTTTTT........
........TTTT........................TTTTTTTT.T.T.......T........
................................TTTTTTTTTTTT.T.TT..TT..T........
................................TTTTTTTTTTTT.T..TTTTT...........
................................TTTTTTTTTTTT.T..TTT.............
................................TTTTTTTTTTTT.TT.TTT.............
....................T..TTTTT....TTTTTTTTTTTTTTTTTTT.............
.....................TTTTTTT....TTTTTTTTTTTTTTTTTTT.............
....................TTTTTTTT....TTTTTTTTTTTTTTTTTTT.............
.....................T.TTTTT....TTTTTTTTTTTT.T.T.T.TTTT.........
.....................T.TTTTT....TTTTTTTTTTTT.T.TTTTTTTT.........
.......................TTTTT....TTTTTTTTTTTT...T.TTTTT..........
........................TTTT....TTTTTTTTTTTT...T.TTTTTTT........
........................TTTT.....TTTTTTTTTTT..T..TTTTTT.........
.........TT.....TTT.....TTTT....TTTTTTTTTTTT..TTTTTTT...........
........T.TT....TTTTTT..TTTT....TTTTTTTTTTTTTTTTTTTTT...........
........T.TT.....TTTT..TTTTT....TTTTTTTTTTTTTTTTTTTTT...........
.........TT.....TTT...TTTTTT....TTTTTTTTTTTTTTTT...T............
................TTTTTTTTTTTT....TTTTTTTTTTTTTTTT................
................TTTTTTTTTTTT....TTTTTTTTTTTTTTTTT...............
................TTTTTTTTTTTT....TTTTTTTTTTTTTTTT................
................TT.T.TT.TTTT....TTTTTTTTTTTTTTTTTTT.............
................................TTTTTTTTTTTTTTTTTTT.............
.................................TTTTTTTTTTTTTTTTTT.............
................................TTTTTTTTTTTTTTTTTTTT............
................................TTTTTTTTTTTTTTTTTTTT............
................................TTTTTTTTT.T.TTTTTTTT............
................................TTTTTTTTT....TTTTTTT............
................................TTTTTTTTT...TTTTTTT.............
................................TTTTTTTT....TTTTT...............
................................TTTTTTTTT..TTTTTTTTTTTT.........
................................TTTTTTTTTTTTTTTTTTTTTTT.........
.................................TTTTTTTTTTTTTTTTTTTTTT.........
................................TTTTTTTTTTTTTTTTTTTTTTT.........
.........................TTT.........TTTTTTTTTTTTT..............
......................TTTTTTTT....TT.TTTTTTTTTTTT...............
......................T...TT.....TT..TTTTTTTTTTTT...............
........................TTT.........TT.TTTTTTTTTT...............
.......................TTTT..........T..TTTT.TT.TTTT............
.........................TTT.........T...TTT..T..TTT............
.......................TTTT..........T....TT..T..TTT............
.......................TTT.T.............TTT...T..T.............
.........................................TTT......T.TTT.........
.........................................TTTTTT....TTTT.........
.........................................T.........TTT..........
.......................................TTTTT........TT..........
.........................................TTTTT.......T..........
...............................................T.....TT.........
................................................................
................................................................
................................................................
................................................................
................................................................
................................................................
