type octile
height 16
width 16
map
...T..T.T.TT....
.....TT.TT.T....
..T......TTT.T..
........TTT.T...
.....TT.TTTTT...
......T.TTT.TT..
..T.T.T.TTTTT...
....TTT.TTTT....
........TTTTT...
........TT.TT...
........TTTTTT..
......T..TTT....
......T...T.T...
..........T..T..
................
................
